NO ./textures/warn.xpm
SO ./textures/wall_s.xpm
WE ./textures/wall_w.xpm
EA ./textures/wall_e.xpm

F 120,130,160
C 144,178,149
        1111111111111111111111111
        1000000000110000000000001
        1011000001110000001000001
        1001000000000000000000001
111111111011000001110000000000001
100000000011000001110111111111111
11110111111111011100000000001
11110111111111011101010010001
11000000110101011100000010001
10001000000000001100000010001
10000000000000001101010010001
1100000111010101111101111000111
11110111 1110101 1Q1111010001
11111111 1111111 111111111111